10 10
@ . . . . . . . . .
. # # # # # # # # .
. # . . . % . . . .
% . . # # # # # # .
# # . # . . . . . .
. . . # . # # # # .
# # . . . % # . # .
$ # # # # . . . . .
. # . . # . # # # .
. . . . . . . . . .