15 15
@ . . . . . . . . . . . . . .
# . # # # # # # # . # # # # .
. . # . . . # . . . . . . . .
. # # % # . . . # # # # # # .
. # . . # . # . . % # . . . .
. . . # # . # # . . # # # # .
. # . . # . . # # . . . . . .
# # # . # # . . # . # # # . #
$ # . . . . . # # . # . # . .
. # # . # # # # . % # . # # .
. # . . . . . . . . . . . # .
. % . # # . . . # . # # # # .
. # # # % . . . . . . . . . .
. # . . . # # . # . # # # # #
. . . # . . . . . . . . . . .